11111111111111111
10000000000000001
10000000000000001
10000000000011001
10001100000011001
10001100000000001
100000000S0000001
10000000000000001
11111111111111111
