11111111111111111
10100000000000001
10111001000011001
1010000000N000001
10101101001111111
10001101000100001
11010001000100111
10000001000000001
11111111111111111
