111111111111111111
100000000000000001
100000000000000001
100011111110000001
100010010010000001
1000110S0110000001
100010010010000001
100011111110000001
100000000000000001
100000000000000001
111111111111111111
