NO textures/zelij.png
SO textures/zelij.png
WE textures/zelij.png
C 255,0,0
F 220,100,3
EA textures/zelij.png


1111111111111111111
1S110000000000000001
1011100100001100111
10100000000000001
10101101001111111
10001101000100001
11010001000100111
10000001000000001
11111111111111111
