
F 220,100,3
C           250,0,0

NO textures/zelij.png


SO textures/zelij.png


WE textures/zelij.png









EA  textures/zelij.png

111111111111111111111111111111
111111111111111111111111111111
100000000000100000000000000011
100000000000100000000000000011
100000000000100000000000000011
100000000000100000000000000011
100000010000000000000000000011
1000000100000000W00000000000011
100000010000000000000000000011
111111111111111111111111111111
