
F 220,100,3
C           250,0,0

NO textures/zelij.png


SO textures/zelij.png


WE textures/zelij.png









EA  textures/zelij.png

1111111111111111111111111111111111111
111111111111111111111111111111111111111111111111111111111111111
1000000000001000000000000000S0100000000000000000010000000000001
100000000000100000000000000000000000000000000000010000000000001
100000000000100000000000000000000000000000000000010000000000001
100000000000100000000000000000000000000000000000010000000000001
100000010000000000000000000000010000000000000000010000000000001
100000010000000000000000000000010000000000000000000000000000001
100000010000000000000000000000010000000000000000000000000000001
111111111111111111111111111111111111111111111111111111111111111
