NO assets/textures/hitler.png
SO assets/textures/nazi3d.png
WE assets/textures/redw3d.png
EA assets/textures/wall3d.png

F 220,100,0
C 225,30,0


        1111111111111111111111111
        10000000001100000000000W1
        1011001001110000010000001
        10010000000000000011000001
111111111011000001110000000000001
100000000011000001110111110111111
11110111111111011100000010001
11110111111110111101010010001
11000000110111011100000010001
10000000100000001100000000001
10000000000000101101010010001
1100000111010101111101111000111
11110111 1110101 101111010001
11111111 1111111 111111111111
