NO textures/backrooms_w.png
SO textures/backrooms_w.png
WE textures/backrooms_w.png
EA textures/backrooms_w.png

F 195,203,110
C 195,203,110


        1111111111111111111111111
        10000e0000110000000000001
        1011001001110000010000001
        1001000002000000011000001
111111111011000001110000000000001
100000000011000001110111112111111
11110111111111011100000010001
11110111111110111101010010001
11000000110111011100000010001
10000000100000001100000020001
10000000000000101101010010a01
11000001110101011111011110N0111
11110111 1110101 101111010001
11111111 1111111 111111111111
