NO textures/nazi3d.png
SO textures/redw3d.png
WE textures/wall3d.png
EA textures/hitler.png

F 220,100,0
C 225,30,0


        1111111111111111111111111
        1000000000110000000000001
        1011001001110000000000001
        1001000000000000001000001
111111111011000001110000000000001
100000000011000001110111111111111
11110111111111011100000010001
11110111111110111101010010001
11000000110111011100000010001
10000000100000001100000010001
1000000000N000101101010010001
11000001110101011111011110e0111
11110111 1110101 101111010001
11111111 1111111 111111111111
