NO textures/nazi3d.png
SO textures/redw3d.png
WE textures/wall3d.png
EA textures/hitler.png

F 220,100,0
C 225,30,0


        1111111111111111111111111
        10000000001100000000000e1
        1011000001210000000000001
        1001000000000000001000001
111111111011000001110000000000001
100000000011000001110111121111111
11110111111111011100000010001
11110111111111011101010010001
11000000110101011100000010001
10000000000000001100000010001
10000000000000001101010010001
1100000111010101111101111000111
11110111 1110001 1011110100N1
11111111 1111111 111111111111
