NO assets/textures/backrooms_w.png
SO assets/textures/backrooms_w.png
WE assets/textures/backrooms_w.png
EA assets/textures/backrooms_w.png

F 195,203,110
C 195,203,110

1111111111111111111111111111111111111111111111111111111111111
1S01000000001000000000001001000001000000000000000001001000001
1G01111001111111111001001001111001111111001001111001001111001
1a00a01000001001000001001001000001000001001001000001000000001
1121001111001001001111001001111001001001001001111001001111001
1001a00000001001001000000001000000001001001001001001000001001
1002001001111001111001111001001111111001001111001111111001001
1001a010000000a1000a010000000a0001001000001001000001001001001
1001111111001111111111001111111001001111111001111001001111001
1001000001000000000000000000001000000000001001000001000001001
1001111001111111001111111111001111111111001001111001001111001
1000000000001000000001000001001000000001000000000000001000001
1111111111001001111111001111111001001001001111001111001001111
10a00000010010000010000000010a0001001001000001001000000000001
1001001001001001111111001111001111001001001111111001111001001
1001001000001001000000000000000001001000000001000001000001001
1001111111001001001111001111001111111111001001111001111001111
1000001000000001001000000001001000001001001000001001000000001
1111001111111111001111111111111111001001111001111001001111111
1001001000000001000000000000001001000001001000001001000001001
1001001001111111001111111111111001001001001111001111111001001
1000000000001000000000000000000000001000000001001000000000001
11110e1111001001001111001111111001111001001111111001111111111
1000000001001001000001000000001001001001000000001000000000001
1111111111111001111111001001001111001001111111001111111111001
1001001000000001000001001001000001001001001000000000000001001
1001001111111111111001001111001001001111001001111111111001111
1000000001000000000000000001001000000000001001001000000000001
1111111001111111111111111001111001111111111111001111001111111
1000000000001001000001000001001000001001000001001001001000001
1001111111001001111001001001001001111001111001001001001111001
1001001001001000000001001001000000000001000000000001000000001
1111001001001001001001001111111111001111111111001111001001111
1000000000000001001000000000000001000000001001001000001000001
1001111001111001111111111111111001111111001001001111111111001
1001000000001001001000000001000001000001001000001000000000001
1001111111001111001111111001001111001001001001001111111111001
1001000001000000000001000000000000001001001001001001001000001
1001001001001111111111001111111111001111001111001001001001001
1001001000000001000000000000001000000001000000001000000001001
1111111111111111111111111111111111111111111111111111111111111
