NO assets/textures/backrooms_w.png
SO assets/textures/backrooms_w.png
WE assets/textures/backrooms_w.png
EA assets/textures/backrooms_w.png

F 195,203,110
C 195,203,110

1111111111111111111111111111111111111111111111111111111111111111111111111111111111111111111111111111111111111111111111111111111111111111111111111111111
1S00000000000000001001001000000000000000001001001000000001000000000001000000000001000000001001000001000001000000000000000001000000001000001000001000001
1001111111111001001001001111001111001001001001001001001111111001111111001111001111001111001001111001001001111001111001111001111001001001111001001111001
10000010000010010010000000000010000010010000000000010000010a0000001000000001001000000001000000000001001000000000001001000000000001000001000001001000001
1111001111001111111001111111111111111111001111111001111001111001001111001111111111111111001111001001001001001001111111111001001001111111001111111001111
10010010010000000000000000010000010010000000a000100100000a000001001000001000000000000000001000001001001001001001001001000001001001001001001001000000001
1001001001111111001001111111001111001001111001111001111111001001111001001001111001111111111001111111111111001001001001111111001111001001001001111001111
1000000000000001001000001000000001000000001000001001000000001001001001001001001000001000001000000000000001001001000001000000000000000001001000000001001
1001111001001111111111111111001111001111111111111111111111111111001111001001001111111111001111111111111001001001001111001111001001111001001111001001001
100100000100100a00100000100100100000a000001000000000000000000001000000000a01001000000000000001000001000000001000000001001000001001000000000000001000001
1111111001111111001001111001001001111111111111111111111111111001111111001001001111111111001111111001111111111111001001111111111111001001001111111111001
10000000000000000010000000000010010010010000000000010000010000000000010010010000a1000000001000001000000000000001001000001001001000001001001000001000001
1111111111111001001001111001001001001001001111001001001111001111111001001111111001111001111111001001111111001111111001111001001001111111111111001111111
1000000000001001001001000001001000000001000001001000001000000000001000000000001000000000001000001000000001000000001000001000000001000000000001001000001
1001001111001001111001001001001111001111111111111001001001111111001111001001111001001001111001111001111001111111111001001001001111111111001111001001001
1001001001001001000001001001000a00000001001000000001000001000001000001001001001001001001001000000001001000001000001001001001000001001000000000000001001
1111001001001001001111111111001111111001001111001001111111001001001111111111001111001001001001111111001001111111001111001001001001001111111001111111001
1001001000001000000000001000001001001000000001001000001001001000001001000000000001001000001000000001001000001000001001001001001001001001000000001001001
1001111001111001001111111111001001001001111111111111001001001001111001001111111111001111001001001111001001001111001001001001001111001001111111001001001
10010000000010010000010000000000000010010000000000010010000010000010010000000000010a1000000001000000001001001000000001001001000000000000001001001000001
10011110011110011110010011111111110a1111001111001111001111111111001001001001001111111111001111001001001111001111001111001111111111111001111001001111111
1000001000000000001001a0100000000000100100000100000000000000100100100100100100000100000000000100100100000100000000100000100000000100a001001001000000001
1001111111001111111111111111111111001001111111111001111001001001111001001001111111001111001111001001111001111001111001111001111111111001001001001111111
1001001000000001001001000000001001001000001000000000001001000000000000001001000000000001000001001001000000a010010e1001000000001001000000001001001000001
1001001001001111001001111111001001001001111111111001111111001111001111001111001111111111001001111111001001001001001001001001111001001111001001001001111
1a000000010000000010000010010000000000010010010010010010010010010010000000000000000000a10a10000000a1001001001001000001001000000000001000000000001000001
1111001111111001001111001001111001111001001001001001001001111001001001111111111111111001111001001111001111111111001111111111111001111001111111001001111
10010010000000010000010000010000010000000010000000000000a1000000001001000a01001000000001001001000001001001001000001000001000000001000001000001000000001
1001111111001111111111001001111111111111001001111001001001111001111111111001001001001001001111111111001001001111111111001111001111001111001111111001001
1000000000000001000001001000001001000001000000001001001001001000001000000000000001001000001000000001001001001001001000001000001000000000001000000001001
1111001111001001001111111001111001001111001111111111001111001001111001111001111001111001001111001111111001001001001001001111001111001001111111111111111
1000001001001001000000000001000001000000001000000001000001000001000000001001000001001001001001000001000001000000001001001001001001001001000001000001001
1001001001001111111001111111001111001111001001001001001001111111111001001111111111001001111001001111001111001111001001111001001001001001001001001111001
1001000001000001001000000000000001000001001001001000001001001000000001001000001000001000000000000001000001000001000000001000000001001000001001001001001
1111001111001111001111001111111001111001001111111001001001001001111111001111001001001001111111111001001111111001111111111111001111111001111111001001001
1000000001000000000001001000001001001001001001001001001001001000001000001000000001000000001000001000001000001001001001001000001001001000000001001000001
1111111111111111111001111001111001001001111001001001111001001111111111001111111111001111001001001001111001111001001001001001111001001111111111001001111
1000000000001001001000000001000000001001000001000000001001000001000001001001001001000001000001001000000000000000000000a01001000000001000001000001001001
1111001111001001001001111111111001111111111001111111001001001111001111111001001001111111111111001111111001111111001111111001001111111001001001111001001
1001000001001000000000000001000001000001000001000001001000001001001000000000000000000000001001001000000001000000000000001000000001000001000001001000001
1001001111111111111001111111001111001111001111001111111111001001001111111001001111111001111001111111001111001111111001001111111001111001111111001001111
1000001001000001000000001001000000000000001000001000000000000001000000000001000000001000001001000000001001001001000001000000001000001000001000001000001
1001001001001111001111111001001111111001111001111111001111111111111001111001111001111111001001111001111001001001111111111001001111111001111001001111001
1001000000000001000000001000000001000001001001001000001001001000000001000001001001000000000000001000001000000000001000000001001001000000000001001000001
1001111111001001111001111001111111001111001001001111001001001111111111111001001111001111111111111001111111111111111001111111001001001001111111001001111
1001000001001000001000000000001000001000000001000000000000001001000000000001000001000001000000000001000000001000001000001000000000001000001000000000001
1001001001001111001001001111111001111111111001111001001001001001001001001001001111001001001111001001001111111001111111001001111111001111111001111111001
1001001000001000000001000001000000001000001000001001001001000001001001001000001001001000001001001000001000000000001000001001000000001001000000001000001
1111001001111001111001001111001111111001111111001001111111111001111001111111111001001111111001111001111001111001111111001111111111001001001001001001001
1001001001000001001001001000001000000000001000001000001000000001000001000000001001000000001000000001000001001000000001000001000000000001001001001001001
1001001001111111001111001111111111111111001111001111111111111111111111111111001001111001001111001001001001001001111001111111111111001001001001001111001
1000001000000000001000000001000000000000001000001001000000000001000000001000001000001001000001001000001001001001000001001001000001001001001001001000001
1111001111001001111111001111001111111001111001001001001111111111111001001001111001001001111111111111001001001111111111001001001001111001001111111111001
1001001000001001000000001000000001001000001001000000000000001000001001001000000001001000001000001001001001000001001001001000001000001001001000000000001
1001111001111111001001001111001001001001001001111001111001111111001001111111001111001001111111001001001001001001001001001111001111001111111001111111111
1001001001000001001001001001001001001001000001001001000000000000001000000000001000000001001001001000001001001000000001000001001000000001001000000000001
1001001111111001001001111001001001001001001111001111111001001111111111111001111001111111001001001001001111001001001111001111001111111001001001001001001
1000001000001001001000001001001001000001000000000001001001001000001001001000001001000000000000000001001001001001001001000001001001000001001001001001001
1001111001111001111111001001001001111001111001111111001001111111001001001001001111111111111001001001001001001111001001001111001001111111001111001001111
1000000000000000000000000001001001000001000001000001001001000000000000001001001001000000001001001001001001000001000000000001001000000000001001001000001
1001001111111001001001111111001111111111111001001111001001111111111111001001111001001001001111001111001001111111111111001111001111001111001001111111111
1001000001000001001001000000000001000000000001001001001000000000000000001000001000001001001001001000000001001001001000001000000000001000001001000000001
1001111001111001111001001111001111001111001111001001001001111111111111111111001111001111111001111001111001001001001111001001001001111001111001111001111
1000001001001001000001001001001001001001000000000000001000000000000001000001000001000000001000001000001000000000000000000001001000001001000001000000001
1111001111001001111111111001111001111001001111111001111001111111001001001111111111001111001111001111001111111001001111111001001001111111001001111111001
1001000000001000000001001001000001000001000000001001000001001000001001001000000000001000001001001000000001000001001000000001001000000001001001000001001
1001001001001001001001001001111001111001111001111111111111001001111001001111111001111001001001001111001111001111111111001111111111111001001001001111001
1000001001001001001001000001000000000001000001000000000001000001001000000000000000001001000000000000001000001000000001001001000001000001001001000001001
1001111111111111111001001111001001001001001111111111111001111001001001001001111001001111111111111001001111001111111001111001001111111001001111111001001
1000001000000000000000000001001001001001001001001001001000000000001001001000001001001000001000001001000001001000000000000001000001000001001001001000001
1001111111001111111001001111111111001111111001001001001111001111111111001111001111111001111001111111001111001001111111001111001001111001001001001111001
1001001000001000001001000000000000001000000001000001000000000001001000001001000001001001000001001001001001001001001001000000001001000001000001000001001
1111001111001111001111001001001111001111111001001001111111001111001001001001111001001001001001001001111001001001001001111001111001111111001111001001001
1001000000000001001000001001000001001000000000001001000000001000000001000001000000001000001000000000000001001000000000001001001001000001000000001001001
1001111111001111001111111111001111111111111111001111111111111111111111111001111111111111111111001001111001001001111001111111001111001111111111111001001
1000001001001001001001000001001001000000000000001000000001000000001000000001000001001001001001001001000000000001001000001000000001001000000000001001001
1001111001111001001001111001111001111001111001111001111111001111001001111001001111001001001001111001001001111001001111001001111001001001111001001001001
1001001000000000000001000000000001000001001000001000000000000001001000001000000001000000001001001001001000001000001001000000001000001001001001000001001
1001001001001001111111111111001001001001001111001001111111111111001001111001001111111001111001001111001001001111111001111111001001001001001111001111001
1001001001001000001000001000001000001000000001000001001000001000001001000001001000000000001000000001001001001000000001000001001001001000001000000000001
1001001111111111001001111001001111111111111001111111001111001001001001111111111111001111111111001001111001111111001001111001111001001111111111001001001
1000000000001000001001001001000000000001001001001000000001000001000001000000001000001000001001001001001000000001001001000000001001000000000000001001001
1111001111111111001001001111001111001111001111001001111001001111001001111111001111001001111001001001001001111001111001001111111111111111111111111111001
1000000001000000000000000001001000001000000000000000001001000001001001000001000001000001000000001000000001000000000000000000000000001001001000000000001
1001111001001001111111111111001111001111111111001111111001111001111001001001001001001001111111001111001111001001001001111111001111111001001111111111111
1000001000001000000000000001000001000001000001000000001000001001000001001001001001001000000000001001000001001001001001001001000001001001001000001000001
1111111111111001111001111001111001111001001001001111001001001001111111111001001111001111111001001001001111001111001111001001001111001001001001111111001
1000000001000001000000001000000001000001001001000001001001001000000001000001000001001000001001001000001001001000001001001000001000001000001001000000001
1111111001111001111001111001111111001111001111001111001111111111111111111001111001001001111111111001111001111111001001001111001111001001111001111001111
1000000001000001001000001000000001000000000001001000001001000000000000001000000000001001001000001000000001000000000000000001001000000000001000001000001
1111001111111111001111001111001001111111001111111001001001111111111111001111111111001001001001111111001111111001111111001111111001111111111001111001111
1000000001000000000000001000001000001001001001000001000001000000001000000001001001001000000000000001001000001001000000001000000001000000000001000000001
1001111111001111001001111111001001111001001001111001001111001001001001001001001001001001111001111001111111001001111001111111001111111001111001001111111
1001001001000001001001001000001001000000001001000001000001001001000001001000001001000000001000001000000000001001001001001001001001000000001000000000001
1001001001111111001111001111111111111001001001001111111111111111111001111001111001111001001001111111001111111111001111001001001001111001111111111001001
1000001000001001000000001000001000000001001000000001001000001000000001001000001001001001001000001000001000000000000001001000000000001000000001001001001
1111001111001001001111001001111111111001111111001001001001111001111001001111111001001001111001111111001001001111111001001001111111001001111111001111001
1000000001000000001001001001000001001001000001001000000000001001000000000000001000000000001000001000000001000001001000000001000000000001000000000000001
1111001111111001001001111001111001001001001111001111111001001001111111001111111001001111001111001001001001111111001001001111111001111001001001001111111
10000000000000010000000000000000010000010000000000000010010000000010000000000000010010000010000010010010000000000010010000000010000010010010010000000G1
1111111111111111111111111111111111111111111111111111111111111111111111111111111111111111111111111111111111111111111111111111111111111111111111111111111
