NO assets/textures/backrooms_w.png
SO assets/textures/backrooms_w.png
WE assets/textures/backrooms_w.png
EA assets/textures/backrooms_w.png

F 195,203,110
C 195,203,110

1111111111111111111111111111111111111111111111111111111111111111111111111111
1S00000001000000000002000000001000000000000000000001001000000000001000000001
1001001001001111111111111111001001111111001001001001001001111001001111001001
1001001000001000000000001000001001001000001001001001000001000001001000001001
1111001111111111001001001001111001001111111121001111111111111111001001111111
1000000000000000001001000000000001000001000001001000001000000000000000001001
1111111001111111001111111111111111001111111001001111001001111001111111001001
1000001001001000001000000000000000000000000000000001001000001001000001000001
1111001001001111111111111111001001001111111111111001001111001111111001111001
1001001001001000000000001000001001000001000000000001000000001001001000000001
1001001111001001111001001111111111111111111111001111111111111001001111001111
1000000001000000001001000001001001000001000001000001001000001000001000000001
1001111001111001111111001111001001001001001111001111001001111001111111111001
1001000001001000000001000000001001001000001001000000000000000001001001000001
1001111111001001111001001111111001001111111001001111111001001111001001001111
1000001001000001001001001001001001000000000001001001001001000001000000001001
1001111001111001001001001001001001111111001111001001001111111111001111111001
1000001001000000001001001000000001000000001a00a00001000000000000000001000001
1001111001001111001001001001001111001001111001111111111001001111001111001111
1000000000000001001001000001001000001001000001000001000001000001001000001001
1001111001111001001111111111111111001111001111001111001111111111111001111001
1000001001000001000001001000000000000001001000000000000001000000001000001001
1001111001111111001111001001111111111111001111001001111111001111111001001001
10000010000010010010000010000000010e100000a000001001001000000001001001001001
1111111001111001111111001111001111001001111111121111001001111111001111001001
10000000000000010010010010000000010010010000000a0001000000001000000000000001
1001111111111001001001001001001111001001111111111001001001001001001001111001
1001000001001000001000001001000000001001002002a00002001001000001001000001001
1001001111001001001111001001111111001111001001111001001001111001001001111001
1000001000000001001001001001000001000000a00a00000a01001000001001001000001001
1111111001111111001001001001001111111111111111111111001111001111111111111001
1001001000001000000001001000000001001000000001000000000001000000000001000001
1001001111111001111001001111001111001111111001001111001111111001211001001111
10010000010000000010010000010010000000010010010010010a0002000002001001000001
1001001001001111001111001111001111001111001001111001111001111121001111111111
1000001000000001001000001000000000000000000000001000001000002000000000001001
1111111111001111001111001111001001001001111111111111001001111111001111111001
1000000000001000001001001001001001001000001000001000a00a00000002002000001001
1001001111001111111001001001111111111001111111001111001001111001111111001001
1001001000001001000000001001000000001000000000001001001000001001000001000001
1111001001001001111001111001111001001001111111111001001211001121111001001001
1000001001000000001000000000001001000001001000000001a000a1000001001000001001
1001111111001111001111111111001111111001001001111001001001111111001111001111
1000001000001000001000000001000000001001000000001001001a000000000000a1000001
10010011111111110010011111111110011110010011111110011111110010a1111001111001
10010010010000000000000000000010000000010010000000000000000010010010a0000001
1111001001111001111111111001001001001111111001111111111111111121001211111001
1000000001001000001000000001000001000001001000000000001001000000001001000001
1111001111001001111111001111111001111001001001001001001001111001111001001001
10000000010000000000010000010000000010000000010010010000000000000000010010G1
1111111111111111111111111111111111111111111111111111111111111111111111111111
