NO assets/textures/backrooms_w.png
SO assets/textures/backrooms_w.png
WE assets/textures/backrooms_w.png
EA assets/textures/backrooms_w.png

F 195,203,110
C 195,203,110

1111111111111111111111111111111111111111111111111111111111111
1S01000000001000000000001001000001000000000000000001001000001
1a01111001111111111001001001111001111111001001111001001111001
10aaa01000001001000001001001000001000001001001000001000000001
1121a01111001001001121001001111001001001001001211001001111001
1001aaaaa0001001001000000001000000001001001002001001000001001
10020010a1111001111001111001001111111001001111001111111001001
10010010aaa00001000a010aaaaaaaaaa1001000001001000001001001001
1001111111a011111111110a11111110a1001111111001111001001111001
1001000001aaaaaaaaaaaaaa00000010aaaaaaaaaa1001000001000001001
10011110011111110011121111110011111111110a1001111001001111001
1000000000001000000001000002002aaaaaaa010a0000000000001000001
1111111111001001111111001111111a01001a010a1211001111001001111
10a00000010010000010000000010aaa01001a010a00010010000000a0001
10010010010010011111110011110a1111001a010a1111111001111001001
10010010000010010aaaaaaaaaaaaa0001001aaaaa0001000001000001001
10011111110010010a1111001111001111111111001001111001111001111
10000010000000010a1000000001001000001001001000002002a000a0001
11110011111111110a1111111111111121001001111001111001001111111
10010010000000010a00000000000e10010aaa010010000010010000a1001
10010010011111110a11111111111110010a1a01001111001111111001001
10000000000010000aaaaaaaaaaaaaaaaaaa1aaaa00001001a00000000001
1111001111001001001111001111111001111001a01111111001111111121
1000000001001001000001000000001001001001aaaaaaa010000000000a1
1111111121111001111111001001001111001001111111a01111111111001
1001001000000001000001001001000001001001001000aaaaaaaaaa01001
1001001111111111111001001111001001001111001001111112111a01111
10000000010000000000000000010010000000000010010010000aaa00001
11111110011111211111111110011110011111111111110011110a1111121
10000000000010010000010000010010000010010000010010010a1000001
10011111110010011110010010010010011110011110010010010a1111001
10010010010010000000010010010000000000010000000000010aaa00001
1111001001001001001001001111211111001111111111001111001a01111
1000000000000001001000000000000001000000001001001000001aaaa01
1001111001111001111111112111111001111111001001001111111111a01
1001000000001001001000000001000001000001001000001000000000a01
1001111111001111001111211001001111001001001001001111111111a01
1001000001000000000001000000000000001001001001001001001000a01
1001001001001111111111001111111111001111001111001001001001a01
1001001000000001000000000000001000000001000000001000000001G01
1111111111111111111111111111111111111111111111111111111111111
